MAP Size
20
12345678901234567890
00000000000000000000
00000000000000000000
00000000000000000000
00000000000000000000
000-00-----00-----00
000-00-00000000-0000
000-00-00000000-0000
000-00-00000000-0000
000-00-00000000-0000
000-00-----0000-0000
000-000000-0000-0000
000-000000-0000-0000
000-000000-0000-0000
000-000000-0000-0000
000-000000-0000-0000
000-00-----0000-0000
00000000000000000000
00000000000000000000
00000000000000000000
00000000000000000000


